A=Buffalo
B=Squirrel
C=Otter
D=Elephant
E=Eagle
F=Lion
G=Lynx
H=Cat
I=Porcupine
J=Snake
K=Lizard
L=Dog
M=Alpaca
N=Parrot
O=Opossum
P=Alligator
Q=Badger
R=Beaver
S=Sheep
T=Bison
U=Bee
V=Crow
W=Woodcock
X=Fox
Y=Armadillo
Z=Dragon
a=Magpie
b=Owl
c=Pelican
d=Zorro
e=Baboon
f=Whale
g=Goose
h=Bandicot
i=Gecko
j=Deer
k=Bat
l=Swan
m=Vulture
n=Jackal
o=Kangaroo
p=Ferrel
q=Stork
r=Crane
s=Heron
t=Chickadee
u=Monkey
v=Capuchin
w=Cardinal
x=Dove
y=Shark
z=Skunk
1=Boar
2=Booby
3=Hyena
4=Tortoise
5=Camel
6=Capybara
7=Chameleon
8=Pheasant
9=Cormorant
0=Cougar
~=Butterfly
!=Mule
@=Horse
#=Puppy
$=Kitty
%=Quoll
^=Cobra
&=Viper
*=Hoopoe
(=Penguin
)=Peregrine
_=Flamingo
+=Gazelle
`=Lourie
-=Groundhog
==Gull
:=Fowl
;=Hippopotamus
